,완전폐쇄형,완전개방형,폐쇄형,개방형,알 수 없음,전체
용산구,0,0,1,70,0,71
영등포구,0,28,0,32,0,60
양천구,0,7,0,16,0,23
송파구,0,0,2,2,0,4
성동구,0,0,0,3,0,3
서대문구,4,3,5,28,0,40
노원구,0,0,0,2,0,2
마포구,0,0,0,0,1,1
광진구,1,15,1,21,180,218
관악구,3,0,1,6,0,10
중랑구,0,0,0,0,248,248
중구,0,0,4,2,0,6
구로구,0,0,0,0,24,24
강서구,4,12,3,13,0,32
강북구,2,1,4,3,0,10
은평구,0,0,308,12,0,320
동작구,0,1,0,0,0,1
동대문구,16,18,7,69,0,110
합계,30,85,336,279,453,1183
